00 00 00 00 00 00 00 00 00 00 00 00
00 00 00 00 00 00 00 00 00 00 00 00
df 19 40 00 00 00 00 00
93 19 40 00 00 00 00 00
a3 19 40 00 00 00 00 00
48 00 00 00 00 00 00 00
ed 19 40 00 00 00 00 00
49 1a 40 00 00 00 00 00
00 1a 40 00 00 00 00 00
b8 19 40 00 00 00 00 00
93 19 40 00 00 00 00 00
ee 18 40 00 00 00 00 00
34 63 39 31 63 35 31 36 00
